SHEEB 3
11 11
3 2 2 2 2 2 2 2 2 2 3 
3 0 0 0 0 0 0 0 0 0 3 
3 0 0 0 0 0 0 0 0 0 3 
3 0 0 0 0 0 0 0 0 0 3 
3 0 0 0 0 0 0 0 0 0 3 
3 0 0 0 0 0 0 0 0 0 3 
3 0 0 0 0 0 0 0 0 0 3 
3 0 0 0 0 0 0 0 0 0 3 
3 0 0 0 0 0 0 0 0 0 3 
3 0 0 0 0 0 0 0 0 0 3 
2 2 2 2 2 2 2 2 2 2 2 
11 11
3 2 2 2 2 2 2 2 2 2 3 
3 0 0 0 0 0 0 0 9 1 3 
3 0 0 0 0 0 0 0 2 2 3 
3 0 0 0 0 0 0 0 0 0 3 
3 0 0 0 0 0 0 0 0 0 3 
3 0 0 0 0 0 0 0 0 0 3 
3 0 0 0 0 0 0 0 0 0 3 
3 0 0 0 0 0 0 0 0 0 3 
3 0 0 0 0 0 0 0 0 0 3 
3 0 0 0 0 0 0 0 0 0 3 
2 2 2 2 2 2 2 2 2 2 2 
11 11
0 0 0 0 0 0 0 0 0 0 0 
0 0 0 0 0 0 0 0 0 0 0 
0 0 0 0 0 0 0 0 0 0 0 
0 0 0 0 0 0 0 0 0 0 0 
0 0 0 0 0 0 0 0 0 0 0 
0 0 0 0 0 0 0 0 0 0 0 
0 0 0 0 0 0 0 0 0 0 0 
0 0 0 0 0 0 0 0 0 0 0 
0 0 0 0 0 0 0 0 0 0 0 
0 0 0 0 0 0 0 0 0 0 0 
0 0 0 0 0 0 0 0 0 0 0 
11 11
0 0 0 0 0 0 0 0 0 0 0 
0 0 0 0 0 0 0 0 0 0 0 
0 0 0 0 0 0 0 0 0 0 0 
0 0 0 0 0 0 0 0 0 0 0 
0 0 0 0 0 0 0 0 0 0 0 
0 0 0 0 0 0 0 0 0 0 0 
0 0 0 0 0 0 0 0 0 0 0 
0 0 0 0 0 0 0 0 0 0 0 
0 0 0 0 0 0 0 0 0 0 0 
0 0 0 0 0 0 0 0 0 0 0 
0 0 0 0 0 0 0 0 0 0 0 
11 11
0 0 0 0 0 0 0 0 0 0 0 
0 0 0 0 0 0 0 0 0 0 0 
0 0 0 0 0 0 0 0 0 0 0 
0 0 0 0 0 0 0 0 0 0 0 
0 0 0 0 0 0 0 0 0 0 0 
0 0 0 0 0 0 0 0 0 0 0 
0 0 0 0 0 0 0 0 0 0 0 
0 0 0 0 0 0 0 0 0 0 0 
0 0 0 0 0 0 0 0 0 0 0 
0 0 0 0 0 0 0 0 0 0 0 
0 0 0 0 0 0 0 0 0 0 0 
11 11
0 0 0 0 0 0 0 0 0 0 0 
0 0 0 0 0 0 0 0 0 0 0 
0 0 0 0 0 0 0 0 0 0 0 
0 0 0 0 0 0 0 0 0 0 0 
0 0 0 0 0 0 0 0 0 0 0 
0 0 0 0 0 0 0 0 0 0 0 
0 0 0 0 0 0 0 0 0 0 0 
0 0 0 0 0 0 0 0 0 0 0 
0 0 0 0 0 0 0 0 0 0 0 
0 0 0 0 0 0 0 0 0 0 0 
0 0 0 0 0 0 0 0 0 0 0 
