Test 7
11 11
3 0 0 0 0 0 0 0 0 0 0 
3 0 0 0 0 0 0 0 0 0 0 
3 0 0 0 0 0 0 0 0 0 0 
3 0 0 0 0 0 0 0 0 0 0 
3 0 0 0 0 0 0 0 0 0 0 
3 0 0 0 0 0 0 0 0 0 0 
3 0 0 0 0 0 0 0 0 0 0 
3 0 0 0 0 0 0 0 0 0 0 
3 0 0 0 0 0 0 0 0 0 0 
3 0 0 0 0 0 0 0 0 0 0 
2 2 2 2 2 0 2 2 2 2 2 
11 11
3 2 2 2 3 0 3 2 2 2 2 
3 0 0 0 2 2 2 0 0 20 3 
3 0 0 11 0 0 0 0 0 0 3 
2 9 11 11 0 0 0 0 0 0 3 
13 0 20 11 11 0 0 0 0 0 20 
3 0 0 0 0 0 11 11 0 0 6 
3 0 0 0 11 11 11 4 0 11 3 
3 0 0 0 11 17 11 11 0 0 3 
3 0 0 0 0 9 0 0 0 0 3 
3 0 0 0 0 0 0 0 0 0 3 
2 2 2 2 2 10 2 2 2 2 2 
11 11
3 0 0 0 0 0 0 0 0 0 0 
3 0 0 0 0 0 3 2 3 0 0 
3 0 0 0 0 0 3 25 3 0 0 
3 0 0 0 0 0 3 0 3 0 0 
2 0 0 0 0 0 11 9 0 2 0 
0 0 0 0 0 0 3 0 3 0 0 
3 0 0 0 0 0 3 0 3 0 0 
3 0 0 0 0 0 3 0 3 0 0 
3 0 0 0 0 0 3 0 3 0 0 
3 0 0 0 0 0 3 12 3 0 0 
2 2 2 2 2 2 2 2 2 2 2 
11 11
3 2 2 2 2 2 2 2 2 2 3 
3 0 0 0 20 0 0 0 0 0 3 
3 0 0 0 0 0 0 0 0 0 3 
3 0 0 0 0 0 0 0 0 0 3 
3 0 0 3 0 3 0 0 0 0 0 
3 0 0 3 1 3 0 0 0 0 3 
3 0 0 2 2 2 0 0 0 0 3 
3 0 0 0 0 0 0 0 0 0 3 
3 0 0 0 0 0 0 0 0 0 3 
3 0 0 0 0 0 0 0 0 0 3 
2 2 2 2 2 2 2 2 2 2 2 
11 11
0 0 0 0 0 0 0 0 0 0 0 
0 0 0 0 0 0 11 0 0 0 0 
0 0 0 0 0 0 0 0 0 0 0 
0 0 0 0 0 0 0 0 0 0 0 
0 0 0 0 0 0 0 0 0 0 0 
0 0 0 0 0 22 0 0 0 0 0 
0 0 0 0 0 11 0 0 0 0 0 
0 0 0 0 0 0 0 0 0 0 0 
0 0 0 0 0 0 0 0 0 0 0 
0 0 0 0 0 0 0 0 0 0 0 
0 0 0 0 0 10 0 0 0 0 0 
11 11
2 2 2 2 2 0 2 2 2 2 3 
0 0 0 0 0 0 0 0 0 0 3 
0 0 0 0 0 0 0 0 0 0 3 
0 0 0 0 0 0 0 0 0 0 3 
0 0 0 0 0 0 0 0 0 0 3 
0 0 0 0 0 0 0 0 0 0 3 
0 0 0 0 0 0 0 0 0 0 3 
0 0 0 0 0 0 0 0 0 0 3 
0 0 0 0 0 0 0 0 0 0 3 
0 0 0 0 0 0 0 0 0 0 3 
0 0 0 0 0 0 0 0 0 0 2 
