Slider#blockage 1
11 11
3 2 2 2 2 2 2 2 2 2 2 
3 0 0 0 0 0 0 0 0 0 0 
3 0 0 0 0 0 0 0 0 0 0 
3 0 0 0 0 0 0 0 0 0 0 
3 0 0 0 0 0 0 0 0 0 0 
3 0 0 0 0 0 0 0 0 0 0 
3 0 0 0 0 0 0 0 0 0 0 
3 0 0 0 0 0 0 0 0 0 0 
3 0 0 0 0 0 0 0 0 0 0 
3 0 0 0 0 0 0 0 0 0 0 
2 0 0 0 0 0 0 0 0 0 0 
11 11
3 2 2 2 2 2 2 2 2 2 3 
3 0 0 0 0 0 0 0 0 22 3 
3 0 0 0 0 0 0 0 0 9 3 
3 0 2 2 2 2 2 2 2 9 3 
3 0 4 0 0 0 0 0 0 24 3 
3 2 2 2 2 2 2 2 2 0 3 
3 0 0 0 0 0 0 0 0 0 3 
3 0 0 11 0 0 0 0 0 0 3 
3 2 2 0 0 0 0 0 0 0 3 
3 1 0 8 0 0 0 0 0 0 3 
2 2 2 2 2 2 2 2 2 2 2 
11 11
0 0 0 0 0 0 0 0 0 0 3 
0 0 0 0 0 0 0 0 0 0 3 
0 0 0 0 0 0 0 0 0 0 3 
0 0 0 0 0 0 0 0 0 0 3 
0 0 0 0 0 0 0 0 0 0 3 
0 0 0 0 0 0 0 0 0 0 3 
0 0 0 0 0 0 0 0 0 0 3 
0 0 0 0 0 0 0 0 0 0 3 
0 0 0 0 0 0 0 0 0 0 3 
0 0 0 0 0 0 0 0 0 0 3 
2 2 2 2 2 2 2 2 2 2 2 
11 11
0 0 0 0 0 0 0 0 0 0 0 
0 0 0 0 0 0 0 0 0 0 0 
0 0 0 0 0 0 0 0 0 0 0 
0 0 0 0 0 0 0 0 0 0 0 
0 0 0 0 0 0 0 0 0 0 0 
0 0 0 0 0 0 0 0 0 0 0 
0 0 0 0 0 0 0 0 0 0 0 
0 0 0 0 0 0 0 0 0 0 0 
0 0 0 0 0 0 0 0 0 0 0 
0 0 0 0 0 0 0 0 0 0 0 
0 0 0 0 0 0 0 0 0 0 0 
11 11
0 0 0 0 0 0 0 0 0 0 0 
0 0 0 0 0 0 0 0 0 0 0 
0 0 0 0 0 0 0 0 0 0 0 
0 0 0 0 0 0 0 0 0 0 0 
0 0 0 0 0 0 0 0 0 0 0 
0 0 0 0 0 0 0 0 0 0 0 
0 0 0 0 0 0 0 0 0 0 0 
0 0 0 0 0 0 0 0 0 0 0 
0 0 0 0 0 0 0 0 0 0 0 
0 0 0 0 0 0 0 0 0 0 0 
0 0 0 0 0 0 0 0 0 0 0 
11 11
0 0 0 0 0 0 0 0 0 0 0 
0 0 0 0 0 0 0 0 0 0 0 
0 0 0 0 0 0 0 0 0 0 0 
0 0 0 0 0 0 0 0 0 0 0 
0 0 0 0 0 0 0 0 0 0 0 
0 0 0 0 0 0 0 0 0 0 0 
0 0 0 0 0 0 0 0 0 0 0 
0 0 0 0 0 0 0 0 0 0 0 
0 0 0 0 0 0 0 0 0 0 0 
0 0 0 0 0 0 0 0 0 0 0 
0 0 0 0 0 0 0 0 0 0 0 
