Level_12 12
11 11
2 2 2 2 2 11 2 2 2 2 2 
2 0 0 0 0 0 19 10 9 1 2 
2 11 2 2 2 0 2 0 0 2 2 
2 0 0 0 0 2 0 2 2 0 2 
2 0 0 0 0 0 0 0 0 0 2 
11 0 0 0 0 0 0 0 0 0 11 
2 0 0 0 0 0 0 0 0 0 2 
2 0 0 0 0 0 0 0 0 0 2 
2 0 0 0 0 0 0 0 0 0 2 
2 0 0 0 0 0 0 0 0 0 2 
2 2 2 2 2 11 2 2 2 2 2 
11 11
2 2 2 2 2 0 2 2 2 2 2 
11 0 0 0 0 0 0 0 11 4 11 
11 0 0 0 0 0 0 0 11 9 11 
11 0 11 11 11 11 11 11 11 11 11 
11 0 0 0 0 0 0 0 0 0 11 
11 0 11 12 0 0 0 0 0 6 11 
11 0 0 0 0 0 0 0 0 0 11 
11 0 0 0 0 0 0 0 0 0 11 
11 0 0 0 0 0 0 0 0 0 11 
11 0 0 0 0 0 0 0 0 0 11 
11 11 11 11 11 11 11 11 11 11 11 
11 11
2 2 2 2 2 0 2 2 2 2 2 
0 0 0 0 0 0 0 0 0 0 0 
0 0 0 0 0 0 0 0 0 0 0 
0 0 0 0 0 0 0 0 0 0 0 
0 0 0 0 0 0 0 0 0 0 0 
0 0 0 0 0 0 0 0 0 0 0 
0 0 0 0 0 0 0 0 0 0 0 
0 0 0 0 0 0 0 0 0 0 0 
0 0 0 0 0 0 0 0 0 0 0 
0 0 0 0 0 0 0 0 0 0 0 
0 0 0 0 0 0 0 0 0 0 0 
11 11
2 2 2 2 2 0 2 2 2 2 2 
0 0 0 0 0 0 0 0 0 0 0 
0 0 0 0 0 0 0 0 0 0 0 
0 0 0 0 0 0 0 0 0 0 0 
0 0 0 0 0 0 0 0 0 0 0 
0 0 0 0 0 0 0 0 0 0 0 
0 0 0 0 0 0 0 0 0 0 0 
0 0 0 0 0 0 0 0 0 0 0 
0 0 0 0 0 0 0 0 0 0 0 
0 0 0 0 0 0 0 0 0 0 0 
0 0 0 0 0 0 0 0 0 0 0 
11 11
2 2 2 2 2 0 2 2 2 2 2 
0 0 0 0 0 0 0 0 0 0 0 
0 0 0 0 0 0 0 0 0 0 0 
0 0 0 0 0 0 0 0 0 0 0 
0 0 0 0 0 0 0 0 0 0 0 
0 0 0 0 0 0 0 0 0 0 0 
0 0 0 0 0 0 0 0 0 0 0 
0 0 0 0 0 0 0 0 0 0 0 
0 0 0 0 0 0 0 0 0 0 0 
0 0 0 0 0 0 0 0 0 0 0 
0 0 0 0 0 0 0 0 0 0 0 
11 11
11 11 11 11 11 11 11 11 11 11 11 
11 0 0 0 0 0 0 0 0 0 11 
11 0 0 0 0 0 0 0 17 0 11 
11 0 0 0 0 0 0 0 0 0 11 
11 0 0 0 0 16 0 0 0 0 11 
11 0 0 0 14 9 13 0 0 0 11 
11 0 0 0 0 15 0 0 0 0 11 
11 0 0 0 0 0 0 0 0 0 11 
11 0 0 0 0 0 0 0 0 0 11 
11 0 0 0 0 0 0 0 0 0 11 
11 11 11 11 11 11 11 11 11 11 11 
