Level_4 4
11 11
2 2 2 2 2 11 2 2 2 2 2 
2 0 0 0 0 0 0 0 0 0 2 
2 0 0 0 0 0 0 0 0 0 2 
2 0 0 0 0 0 0 0 0 0 2 
2 0 0 0 0 0 0 0 0 0 2 
11 0 0 0 0 0 0 0 0 0 11 
2 0 0 0 0 0 0 0 0 0 2 
2 0 0 0 0 0 0 6 6 8 2 
2 0 0 0 0 0 0 6 9 9 2 
2 0 0 0 0 0 0 6 9 17 2 
2 2 2 2 2 11 2 2 2 2 2 
11 11
2 2 2 2 2 11 2 2 2 2 2 
2 0 0 0 0 0 0 20 9 1 2 
2 0 0 0 0 0 0 0 2 2 2 
2 0 0 0 0 0 0 0 0 0 2 
2 0 0 0 0 0 0 0 0 0 2 
11 0 0 0 0 0 0 0 0 0 11 
2 0 0 0 0 0 0 0 0 0 2 
2 0 0 0 0 0 0 0 0 0 2 
2 0 0 0 0 0 0 0 0 0 2 
2 0 0 0 0 0 0 0 0 0 2 
2 2 2 2 2 11 2 2 2 2 2 
11 11
2 2 2 2 2 11 2 2 2 2 2 
2 0 0 0 0 9 0 0 0 0 2 
2 0 0 0 0 11 0 0 0 0 2 
2 0 2 2 2 2 2 2 2 2 2 
2 0 0 0 0 0 0 0 0 0 2 
11 9 11 0 0 0 0 0 0 9 11 
2 0 0 0 0 0 0 0 0 0 2 
2 2 2 2 2 2 2 2 2 0 2 
2 0 0 0 0 0 0 0 0 0 2 
2 0 0 0 0 9 0 0 0 0 2 
2 2 2 2 2 11 2 2 2 2 2 
11 11
2 2 2 2 2 11 2 2 2 2 2 
2 0 0 0 0 0 0 0 0 0 2 
2 0 0 0 0 0 0 0 0 0 2 
2 0 0 0 0 0 0 0 0 0 2 
2 0 0 0 0 9 0 0 0 0 2 
11 0 0 0 0 0 0 0 0 0 11 
2 0 0 0 0 0 0 0 0 0 2 
2 0 0 0 0 0 0 4 0 0 2 
2 0 0 0 0 0 0 0 0 0 2 
2 0 0 0 0 0 0 0 0 0 2 
2 2 2 2 2 11 2 2 2 2 2 
11 11
2 2 2 2 2 11 2 2 2 2 2 
2 0 0 0 0 0 0 0 0 0 2 
2 0 0 0 0 0 0 0 0 0 2 
2 0 0 0 0 0 0 0 0 0 2 
2 0 0 0 0 0 0 0 0 0 2 
11 0 0 0 0 0 0 0 0 0 11 
2 0 0 0 0 0 0 0 0 0 2 
2 0 0 0 0 0 0 0 0 0 2 
2 0 0 0 0 0 0 0 0 0 2 
2 0 0 0 0 0 0 0 0 0 2 
2 2 2 2 2 11 2 2 2 2 2 
11 11
2 2 2 2 2 11 2 2 2 2 2 
2 0 0 0 0 0 2 2 0 0 2 
2 0 0 0 0 0 2 0 0 0 2 
2 0 0 2 2 2 2 0 0 0 2 
2 0 0 0 0 0 0 0 0 0 2 
11 0 0 0 0 0 0 0 0 0 11 
2 0 0 0 0 0 0 0 0 0 2 
2 0 0 0 0 2 2 2 2 0 2 
2 0 0 0 2 2 0 0 0 0 2 
2 0 0 0 2 0 0 0 0 0 2 
2 2 2 2 2 11 2 2 2 2 2 
