Level2 8
11 11
2 2 2 2 2 0 2 2 2 2 2 
2 0 0 0 0 0 0 0 0 0 2 
2 0 0 0 0 0 0 0 0 0 2 
2 10 10 10 10 10 10 10 10 10 2 
2 9 9 9 9 9 9 9 9 9 2 
0 0 0 0 0 0 0 0 0 0 0 
2 0 0 0 0 0 0 0 0 0 2 
2 10 10 10 10 10 10 10 10 10 2 
2 0 0 0 0 0 0 0 0 0 2 
2 0 0 0 0 0 0 0 0 0 2 
2 2 2 2 2 0 2 2 2 2 2 
11 11
2 2 2 2 2 0 2 2 2 2 2 
2 0 0 0 0 0 0 0 0 0 2 
2 0 0 0 0 0 0 0 0 0 2 
2 0 0 0 0 0 0 0 0 0 2 
2 0 0 0 0 0 0 0 0 0 2 
0 0 0 0 0 0 0 0 0 0 0 
2 0 0 0 0 0 0 0 0 0 2 
2 0 0 0 0 0 0 0 0 0 2 
2 0 0 0 0 0 0 0 0 0 2 
2 0 0 0 0 0 0 0 0 0 2 
2 2 2 2 2 0 2 2 2 2 2 
11 11
2 2 2 2 2 0 2 2 2 2 2 
2 0 0 0 0 0 9 10 0 0 2 
2 0 0 0 0 0 9 10 0 0 2 
2 0 0 0 0 0 9 10 0 0 2 
2 0 0 0 0 0 9 10 0 0 2 
0 0 0 0 0 0 9 10 0 0 0 
2 0 0 0 0 0 9 10 0 0 2 
2 0 0 0 0 0 9 10 0 0 2 
2 0 0 0 0 0 9 10 0 0 2 
2 0 0 0 0 0 9 10 0 0 2 
2 2 2 2 2 0 2 2 2 2 2 
11 11
2 2 2 2 2 0 2 2 2 2 2 
2 0 0 10 9 0 0 0 0 0 2 
2 0 0 10 9 0 0 0 0 0 2 
2 0 0 10 9 0 0 0 0 0 2 
2 0 0 10 9 0 0 0 0 0 2 
0 0 0 10 9 0 0 0 0 0 0 
2 0 0 10 9 0 0 0 0 0 2 
2 0 0 10 9 0 0 0 0 0 2 
2 0 0 10 9 0 0 0 0 0 2 
2 0 0 10 9 0 0 0 0 0 2 
2 2 2 2 2 0 2 2 2 2 2 
11 11
2 2 2 2 2 0 2 2 2 2 2 
2 0 0 0 0 0 0 0 0 0 2 
2 0 0 0 0 0 0 0 0 0 2 
2 0 0 0 0 0 0 0 0 0 2 
2 0 0 0 2 2 2 0 0 0 2 
0 0 0 0 2 1 2 0 0 0 0 
2 0 0 0 2 9 2 0 0 0 2 
2 0 0 0 0 0 0 0 0 0 2 
2 0 0 0 0 0 0 0 0 0 2 
2 0 0 0 0 0 0 0 0 0 2 
2 2 2 2 2 0 2 2 2 2 2 
11 11
2 2 2 2 2 0 2 2 2 2 2 
2 0 0 0 0 0 0 0 0 0 2 
2 0 0 0 0 0 0 0 0 0 2 
2 0 0 0 0 0 0 0 0 0 2 
2 0 0 0 0 0 0 0 0 0 2 
0 0 0 0 0 0 0 0 0 0 0 
2 9 9 9 9 9 9 9 9 9 2 
2 10 10 10 10 10 10 10 10 10 2 
2 0 0 0 0 0 0 0 0 0 2 
2 0 0 0 0 0 0 0 0 0 2 
2 2 2 2 2 0 2 2 2 2 2 
