Test 4
11 11
2 2 2 2 2 8 2 2 2 2 2 
2 0 0 0 0 0 0 0 0 0 2 
2 0 0 0 0 0 0 0 0 0 2 
2 0 0 0 0 0 0 0 0 0 2 
2 0 0 0 0 0 0 0 0 0 2 
8 0 0 0 0 0 0 0 0 0 8 
2 0 0 0 0 0 0 0 0 0 2 
2 0 0 0 0 0 0 0 0 0 2 
2 0 0 0 0 0 0 0 0 0 2 
2 0 0 0 0 0 0 0 0 0 2 
2 2 2 2 2 8 2 2 2 2 2 
11 11
2 2 2 2 2 8 2 2 2 2 2 
2 0 0 0 0 0 0 0 0 0 2 
2 0 0 0 0 0 0 0 0 0 2 
2 0 0 0 0 0 0 0 0 0 2 
2 0 0 0 0 0 0 0 0 0 2 
8 0 0 0 0 0 0 0 0 0 8 
2 0 0 0 0 0 0 0 0 0 2 
2 0 0 0 0 0 0 0 0 0 2 
2 0 0 0 0 0 0 0 0 0 2 
2 0 0 0 0 0 0 0 0 0 2 
2 2 2 2 2 8 2 2 2 2 2 
11 11
2 2 2 2 2 8 2 2 2 2 2 
2 0 0 0 0 0 0 0 0 0 2 
2 0 0 0 0 0 0 0 0 0 2 
2 0 0 0 0 0 0 0 0 0 2 
2 0 0 0 0 0 0 0 0 0 2 
8 0 0 0 0 0 0 0 0 0 8 
2 0 0 0 0 0 0 0 0 0 2 
2 0 0 0 0 0 0 0 0 0 2 
2 0 0 0 0 0 0 0 0 0 2 
2 0 0 0 0 0 0 0 0 0 2 
2 2 2 2 2 8 2 2 2 2 2 
11 11
2 2 2 2 2 8 2 2 2 2 2 
2 0 0 0 0 0 0 0 0 0 2 
2 0 0 0 0 0 0 0 0 0 2 
2 0 0 0 0 0 0 0 0 0 2 
2 0 0 0 0 0 0 0 0 0 2 
8 0 0 0 0 0 0 0 0 0 8 
2 0 0 0 0 0 0 0 0 0 2 
2 0 0 0 0 0 0 0 0 0 2 
2 0 0 0 0 0 0 0 0 0 2 
2 0 0 0 0 0 0 0 0 0 2 
2 2 2 2 2 8 2 2 2 2 2 
11 11
2 2 2 2 2 8 2 2 2 2 2 
2 0 0 0 0 0 0 0 0 0 2 
2 0 0 0 0 0 0 0 0 0 2 
2 0 0 0 0 0 0 0 0 0 2 
2 0 0 0 0 0 0 0 0 0 2 
8 0 0 0 0 0 0 0 0 0 8 
2 0 0 0 0 0 0 0 0 0 2 
2 0 0 0 0 0 0 0 0 0 2 
2 0 0 0 0 0 0 0 0 0 2 
2 0 0 0 0 0 0 0 0 0 2 
2 2 2 2 2 8 2 2 2 2 2 
11 11
2 2 2 2 2 8 2 2 2 2 2 
2 0 0 0 0 0 0 0 0 0 2 
2 0 0 0 0 0 0 0 0 0 2 
2 0 0 0 0 0 0 5 0 0 2 
2 0 0 0 0 0 0 0 0 0 2 
8 0 0 0 0 0 0 0 0 0 8 
2 0 0 0 0 0 0 0 0 0 2 
2 0 0 4 0 0 0 0 0 0 2 
2 0 0 0 0 0 0 0 0 0 2 
2 0 0 0 0 0 0 0 0 0 2 
2 2 2 2 2 8 2 2 2 2 2 
