Slider+Flag_Test 3
11 11
2 2 2 2 2 0 2 2 2 2 2 
2 0 0 0 0 0 0 0 0 0 2 
2 0 0 0 0 0 0 0 0 0 2 
2 0 0 0 0 0 0 0 0 0 2 
2 0 0 0 0 0 7 0 0 0 2
0 0 0 0 0 0 0 0 0 0 0
2 0 0 0 0 0 0 0 0 0 2 
2 0 0 0 0 0 0 0 0 0 2 
2 0 0 0 0 0 0 0 0 0 2 
2 0 0 0 0 0 0 0 0 0 2 
2 2 2 2 2 0 2 2 2 2 2 
11 11
0 0 0 0 0 0 6 0 2 7 2 
0 0 0 0 0 0 0 0 2 8 2
0 0 5 0 0 0 0 0 2 2 2
0 4 0 0 0 0 0 0 0 2 1
0 0 0 0 0 0 0 0 0 0 7
0 2 2 2 2 0 2 2 2 2 11
0 2 10 0 0 0 0 0 9 2 0
0 2 2 0 2 2 2 2 2 2 0 
0 0 0 0 0 0 0 0 0 0 0 
0 0 0 0 0 0 0 0 0 0 0 
0 0 0 0 0 0 0 0 0 0 0 
11 11
0 0 0 0 0 0 0 0 0 0 0 
0 0 0 0 0 0 0 0 0 0 0 
0 0 0 0 0 0 0 0 0 0 0 
0 0 0 0 0 0 0 0 0 0 0 
0 0 0 0 0 7 0 0 0 0 0
0 0 0 0 0 0 0 0 0 0 0 
0 0 0 0 0 0 0 0 0 0 0 
0 0 0 0 0 0 0 0 0 0 0 
0 0 0 0 0 0 0 0 0 0 0 
0 0 0 0 0 0 0 0 0 0 0 
0 0 0 0 0 0 0 0 0 0 0 
11 11
0 0 0 0 0 0 0 0 0 0 0 
0 0 0 0 0 0 0 0 0 0 0 
0 0 0 0 0 0 0 0 0 0 0 
0 0 0 0 0 0 0 7 0 0 0
0 0 0 0 0 0 0 0 0 0 0 
0 0 0 0 0 0 0 0 0 0 0 
0 0 0 0 0 0 0 0 0 0 0 
0 0 0 0 0 0 0 0 0 0 0 
0 0 0 0 0 0 0 0 0 0 0 
0 0 0 0 0 0 0 0 0 0 0 
0 0 0 0 0 0 0 0 0 0 0 
11 11
0 0 0 0 0 0 0 0 0 0 0 
0 0 0 0 0 0 0 0 0 0 0 
0 0 0 0 0 0 0 0 0 0 0 
0 0 0 0 0 0 0 0 0 0 0 
0 0 0 0 0 0 0 0 0 0 0 
0 0 0 0 0 0 7 0 0 0 0
0 0 0 0 0 0 0 0 0 0 0 
0 0 0 0 0 0 0 0 0 0 0 
0 0 0 0 0 0 0 0 0 0 0 
0 0 0 0 0 0 0 0 0 0 0 
0 0 0 0 0 0 0 0 0 0 0 
11 11
0 0 0 0 0 0 0 0 0 0 0 
0 0 0 0 0 0 0 0 0 0 0 
0 0 0 0 0 0 0 0 0 0 0 
0 0 0 0 0 0 0 0 0 0 0 
0 0 0 0 0 0 0 0 0 0 0 
0 0 0 0 0 0 0 0 0 0 0 
0 0 0 0 0 7 0 0 0 0 0
0 0 0 0 0 0 0 0 0 0 0 
0 0 0 0 0 0 0 0 0 0 0 
0 0 0 0 0 0 0 0 0 0 0 
0 0 0 0 0 0 0 0 0 0 0 
