switch#places 13
11 11
2 2 2 2 2 11 2 2 2 2 2 
2 0 0 0 0 0 0 0 0 0 2 
2 0 0 0 0 0 0 0 0 0 2 
2 0 0 0 0 0 0 0 0 0 2 
2 0 0 0 0 0 0 0 0 0 2 
11 0 0 0 0 0 0 0 0 0 11 
2 0 0 0 0 0 0 0 0 0 2 
2 0 0 0 0 0 0 0 0 0 2 
2 0 0 0 0 0 0 0 0 0 2 
2 0 0 0 0 0 0 0 0 0 2 
2 2 2 2 2 11 2 2 2 2 2 
11 11
2 2 2 2 2 11 2 2 2 2 2 
2 0 0 0 0 0 0 0 0 0 2 
2 0 0 0 0 0 0 0 0 0 2 
2 0 0 0 0 0 0 0 0 0 2 
2 0 0 0 0 0 0 0 0 0 2 
11 0 0 0 0 0 0 0 0 0 11 
2 0 0 0 0 0 0 0 0 0 2 
2 0 0 0 0 0 0 0 0 0 2 
2 0 0 0 0 0 0 0 0 0 2 
2 0 0 0 0 0 0 0 0 0 2 
2 2 2 2 2 11 2 2 2 2 2 
11 11
2 2 2 2 2 11 2 2 2 2 2 
2 0 0 0 0 0 0 0 0 0 2 
2 0 0 0 0 0 0 0 0 0 2 
2 0 0 0 0 0 0 0 0 0 2 
2 0 0 0 0 0 0 0 0 0 2 
11 0 0 0 0 0 0 0 0 0 11 
2 0 0 0 0 0 0 0 0 0 2 
2 0 0 0 0 0 0 0 0 0 2 
2 0 0 0 0 0 0 0 0 0 2 
2 0 0 0 0 0 0 0 0 0 2 
2 2 2 2 2 11 2 2 2 2 2 
11 11
2 2 2 2 2 11 2 2 2 2 2 
2 0 0 0 10 0 0 0 0 0 2 
2 0 0 0 0 0 0 0 0 0 2 
2 0 0 0 0 0 0 0 0 0 2 
2 0 0 0 0 0 0 0 0 0 2 
11 0 0 0 0 0 0 0 0 0 11 
2 0 0 0 0 0 0 0 0 0 2 
2 0 0 0 0 0 2 2 2 2 2 
2 0 0 0 0 0 2 0 0 4 2 
2 0 0 0 0 0 0 0 0 0 2 
2 2 2 2 2 11 2 2 2 2 2 
11 11
2 2 2 2 2 11 2 2 2 2 2 
2 0 0 0 0 0 0 0 0 0 2 
2 0 0 0 0 0 0 0 0 0 2 
2 0 0 0 0 0 0 0 0 0 2 
2 0 0 0 0 0 0 0 0 0 2 
11 0 0 0 0 0 0 0 0 0 11 
2 0 0 0 0 0 0 0 0 0 2 
2 0 0 0 0 0 0 0 0 0 2 
2 0 0 0 0 0 0 0 0 0 2 
2 0 0 0 0 0 0 0 0 0 2 
2 2 2 2 2 11 2 2 2 2 2 
11 11
2 2 2 2 2 11 2 2 2 2 2 
2 0 0 2 2 10 2 0 0 0 2 
2 0 2 1 0 0 2 0 0 0 2 
2 0 0 2 2 9 2 0 0 0 2 
2 0 0 0 2 7 2 0 0 0 2 
11 0 0 0 2 0 2 0 0 0 11 
2 0 0 0 0 2 0 0 0 0 2 
2 0 0 0 0 0 0 0 0 0 2 
2 0 0 0 0 0 0 0 0 0 2 
2 0 0 0 0 0 0 0 0 0 2 
2 2 2 2 2 11 2 2 2 2 2 
